{
  "id": 5,
  "algorithm": "DFS",
  "width": "15",
  "height": "10",
  "walls": [
    ["1","1","1","1","1","1","1","1","1","1"],
    ["1","1","0","0","0","1","1","1","1","1"],
    ["1","1","0","1","0","0","1","1","1","1"],
    ["1","1","0","1","1","0","0","1","1","1"],
    ["1","0","0","0","1","1","0","1","1","1"],
    ["1","0","0","0","0","0","0","1","1","1"],
    ["1","1","0","1","0","1","0","1","1","1"],
    ["1","1","0","0","0","0","0","0","0","1"],
    ["1","1","0","1","0","1","0","1","1","1"],
    ["1","0","0","0","0","0","0","1","1","1"],
    ["1","0","0","0","1","1","0","1","1","1"],
    ["1","1","0","1","1","0","0","1","1","1"],
    ["1","1","0","1","0","0","1","1","1","1"],
    ["1","1","0","0","0","1","1","1","1","1"],
    ["1","1","1","1","1","1","1","1","1","1"]
  ],
  "player": {
    "x": "7",
    "y": "2"
  },
  "boxes": [
    {
      "x": "6",
      "y": "2"
    },
    {
      "x": "8",
      "y": "2"
    }
  ],
  "winPoints": [
    {
      "x": "7",
      "y": "7"
    },
    {
      "x": "7",
      "y": "8"
    }
  ]
}