{
  "id": 7,
  "width": "15",
  "height": "14",
  "walls": [
    ["1","1","1","1","1","1","1","1","1","1","1","1","1","1"],
    ["1","1","1","1","1","0","0","0","1","1","1","1","1","1"],
    ["1","1","0","0","1","0","0","0","1","1","1","1","1","1"],
    ["1","0","0","0","1","0","0","0","0","0","1","1","1","1"],
    ["1","0","0","0","1","1","0","1","1","1","1","1","1","1"],
    ["1","1","0","1","1","0","0","0","1","0","0","0","1","1"],
    ["1","1","0","1","0","0","0","0","1","1","0","0","0","1"],
    ["1","1","0","0","0","0","0","0","0","0","0","0","0","1"],
    ["1","1","0","1","0","0","0","0","0","1","0","0","0","1"],
    ["1","1","0","1","1","0","0","0","1","1","1","1","1","1"],
    ["1","1","0","1","1","1","0","1","1","0","1","1","1","1"],
    ["1","1","0","1","1","0","0","1","0","0","1","1","1","1"],
    ["1","1","0","0","0","0","0","0","0","0","1","1","1","1"],
    ["1","1","1","1","1","0","0","1","0","0","1","1","1","1"],
    ["1","1","1","1","1","1","1","1","1","1","1","1","1","1"]
  ],
  "player": {
    "x": "7",
    "y": "6"
  },
  "boxes": [
    {
      "x": "6",
      "y": "6"
    },
    {
      "x": "8",
      "y": "6"
    },
    {
      "x": "7",
      "y": "5"
    },
    {
      "x": "7",
      "y": "7"
    }
  ],
  "winPoints": [
    {
      "x": "4",
      "y": "3"
    },
    {
      "x": "3",
      "y": "9"
    },
    {
      "x": "5",
      "y": "9"
    },
    {
      "x": "10",
      "y": "9"
    }
  ]
}